-222222222222
-24003000000222
220002202242002
200000000000002
200042200030022
22200000022222
--20000002
2220300022222
2000000010002
2222222222222
