2222222222
2004400042
2003300032
2000000002
2001000002
2000000002
2000000002
2000000002
2222222222