{2222222222
{2000000002
{2001330002
{2000000402
{2000000002
{2030000002
{2000000002
{2004000002
{2400000002
{2222222222